000000000000000000000000
00X0P000000XXXXXX000XXX0
00XXX000XXXX000000000000
00X0000000000000000000X0
XXXXXXX00XXXXX000000XXXX
000000000000000000000000
000000000000XXXXXXXX0000
0000000000XX0000000000X0
0000000XXXXX0000000XXXXX
XXXXXXXXXXXX000XXXXXXX00